0000000000000000000000000000
0333333333333003333333333330
0300003000003003000003000030
0303303033303003033303033030
0300003000003003000003000030
0333333333333333333333333330
0300003003000000003003000030
0300003003000000003003000030
0333333003333003333003333330
0000003000003003000003000000
0333303000003003000003033330
0333303003333333333003033330
0333303003000000003003033330
0000003003033333303003000000
0333303333033333303333033330
0000003003033333303003000000
0333303003000000003003033330
0333303003333333333003033330
0333303003000000003003033330
0000003003000000003003000000
0333333333333003333333333330
0300003000003003000003000030
0300003000003003000003000030
0333003333333333333331003330
0003003003000000003003003000
0003003003000000003003003000
0333333003333003333003333330
0300000000003003000000000030
0300000000003003000000000030
0333333333333333333333333330
0000000000000000000000000000