4888888888888548888888888885
9111111111111991111111111119
9148851488851991488851488519
9293391933391991933391933929
9168871688871671688871688719
9111111111111111111111111119
9148851451488888851451488519
9168871991688548871991688719
9111111991111991111991111119
6888851968853993488791488887
3333391948873673688591933333
3333391993333333333991933333
3333391993488008853991933333
8888871673933333393671688888
3333301333933333393331033333
8888851453933333393451488888
3333391993688888873991933333
3333391993333333333991933333
3333391993488888853991933333
4888871673688548873671688885
9111111111111991111111111119
9148851488851991488851488519
9168591688871671688871948719
9211991111111331111111991129
6851991451488888851451991487
4871671991688548871991671685
9111111991111991111991111119
9148888768851991488768888519
9168888888871671688888888719
9111111111111111111111111119
6888888888888888888888888887