0000000000000000000000000000
0111111111111001111111111110
0100001000001001000001000010
0203301033301001033301033020
0100001000001001000001000010
0111111111111111111111111110
0100001001000000001001000010
0100001001000000001001000010
0111111001111001111001111110
0000001000003003000001000000
0333301000003003000001033330
0333301003333333333001033330
0333301003000000003001033330
0000001003033333303001000000
0333301333033333303331033330
0000001003033333303001000000
0333301003000000003001033330
0333301003333333333001033330
0333301003000000003001033330
0000001003000000003001000000
0111111111111001111111111110
0100001000001001000001000010
0100001000001001000001000010
0211001111111331111111001120
0001001001000000001001001000
0001001001000000001001001000
0111111001111001111001111110
0100000000001001000000000010
0100000000001001000000000010
0111111111111111111111111110
0000000000000000000000000000