0000000000000000000000000000
0111111111111111111111111110
0133333333333333333333333310
0133333333333333333333333310
0133333333333333333333333310
0133333333333333333333333310
0133333333333333333333333310
0133333333333333333333333310
0133333333333333333333333310
0133333333333333333333333310
0133333333333333333333333310
0133333333333333333333333310
0133333333333333333333333310
0133333333333333333333333310
0133333333333333333333333310
0133333333333333333333333310
0133333333333333333333333310
0133333333333333333333333310
0133333333333333333333333310
0133333333333333333333333310
0133333333333333333333333310
0133333333333333333333333310
0133333333333333333333333310
0133333333333333333333333310
0133333333333333333333333310
0133333333333333333333333310
0133333333333333333333333310
0133333333333333333333333310
0133333333333333333333333310
0111111111111111111111111110
0000000000000000000000000000